ଏହି ପୃଷ୍ଠାରେ କିଛି ଓଡ଼ିଆ ମସଲା ଏବଂ ତାହାର ଇଂରାଜୀ ପ୍ରତିଶବ୍ଦ ରଖାଯାଇଛି ।

ଅଦା - Ginger
ଚାରୁ ମଞ୍ଜି -Chironji
ଆମ୍ବ ଅଦା  - Mango ginger
ସୋରିଷ - Mustard
ପୋସ୍ତୋ - Poppy seeds
ପାନମଧୂରୀ - Fennel
ଜିରା - Cumin
ଲଙ୍କା - Chilli
ମେଥୀ - fenugreek
କଳାଜିରା - Nigella
ଖଜୁରି -Dates
ବାଦାମ - Almonds
ଧନିଆ - Coriander
ଧନିଆ ପତ୍ର- Coriander leaves
ତେଜ ପତ୍ର - Bay leaf
ଡାଲ୍‌ଚିନି - Cinnamon
ଅଳେଇଚ - Cardamon
ଲବଙ୍ଗ Labanga - Cloves
ହିଙ୍ଗୁ - Asafoetida
ଶୁଣ୍ଠି- Dry Ginger
ଜାଇ ଫଳ - Nutmeg
ଜାଇତ୍ରି- Mace
ଜୁଆଣୀ- Carom 
ହଲଦi - Turmeric
କଳା ମରିଚ - Peppercorns
ରାଶି Rasi - Sesame
ଜୁଆଣି - Carom seeds
ଆମ୍ବୁଲ  - Dry Mango slices 
ନଡିଆ କୋରୋ - Shredded Coconut
ରସୁଣ - Garlic
ତେନ୍ତୁଳୀ - Tamarind
ଳୁଣ - Salt
ଭୁର୍‌ସୁଙ୍ଗା ପତ୍ର - curry leaves
କର୍ପୁର - Camphor
ଚିନା ବାଦାମ୍‌ - Peanuts
କୁଙ୍କୁମ ଫୁଲ - Saffron
